11111111111111111111111111111
14444444144444444444144444441
14111111141411111414111111141
14444444441444444414444444441
14111411111411111411111411141
14444444444414441444444444441
14141111141444144414111114141
14444444441411111414444444441
14141111111444144411111114141
14444444444414441444444444441
14111111141411111414111111141
14444444441444444414444444441
14111411111411111411111411141
14441444444444444444444414441
11111111111111111111111111111